34 15 1
00000000000000000001111111100003
00000000000000000001000000000003
00000000000000000000000000110003
00000000000000000001000001100003
00000000000000000001110000000003
00000000000000000001111111100003
00000000000000000001000000000003
00000000000000000000000000110003
00000000000000000001000001100003
00000000000000000001110000000003
11110000000000000001011111110003
11111100000001111111111111111113
11111111111111111111111222211113
22222111111111112222222222222213
22222222222222222222222222222223