34 12 1
00000000000000011111111111111103
00000111111111111111111111110003
00000000000111111111112222111003
00000001111111111222222222222203
00000111122222222000022222200003
00000000002222000000002222000003
00000000002220000000002222000003
11110000002220000000011111110003
11111100002220000011111111111113
11111111111111111111111222211113
22222111111111112222222222222213
22222222222222222222222222222223